####################
#                  #
#                  #
#                  #
# * *  * *  * * *  #
#  * *  *  * * * * #
#     *   *        #
#                  #
#                  #
#                  #
#                  #
#                  #
#                  #
#   *  * *  * *    #
#    *  *  * *     #
#                  #
#                  #
#                  #
#                  #
#                  #
#                  #
#   *  * *  * *    #
#    *  *  * *     #
#                  #
#                  #
#                  #
#                  #
#                  #
#                  #
#                  #
#                  #
#    * *   *  *    #
#    * *   *  *    #
#    * *   *  *    #
# * *  * *  * * *  #
# * *  * *  * * *  #
# * *  * *  * * *  #
#  * *  *  * * * * #
#     *   *        #
#  * *  *  * * * * #
#     *   *        #
#  * *  *  * * * * #
#     *   *        #
#                  #
#                  #
# * *  * *  * * *  #
#  * *  *  * * * * #
#     *   *        #
#                  #
#                  #
# * *  * *  * * *  #
#  * *  *  * * * * #
#     *   *        #
#                  #
#                  #
#   *  * *  * *    #
#    *  *  * *     #
#                  #
#                  #
# * *  * *  * * *  #
# * *  * *  * * *  #
# * *  * *  * * *  #
# * *  * *  * * *  #
# * *  * *  * * *  #
# * *  * *  * * *  #
# * *  * *  * * *  #
#  * *  *  * * * * #
#     *   *        #
#  * *  *  * * * * #
#     *   *        #
#  * *  *  * * * * #
#     *   *        #
#  * *  *  * * * * #
#     *   *        #
#  * *  *  * * * * #
#     *   *        #
#  * *  *  * * * * #
#     *   *        #
#  * *  *  * * * * #
#     *   *        #
#                  #
#    * *   *  *    #
#                  #
#                  #
#                  #
#                  #
#        @         #
#                  #
#        #         #
#        #         #
#        #         #
####################
